111111000000000
111111000000000
111111111110000
111111111110000
000011111100000
000111111000000
001111111110000
000001111110000
000001111110000
000000111111000
