111111JCCCCCCCC
111111IHHHHHHHH
DE1111000000000
CF1111000000000
CF1111111111111
CF1111111111111
CCDE11111111111
CCCF111111111MM
CCCF11111111111
CCCF11111111111
