00000000000CCCC
01111111111HHHH
011111111110000
011Q11111110000
011111111111111
011111111111111
11111111111111N
CCCF1111111111N
CCCF11111111111
CCCF11111111111
