00000000000CCCC
01111111111HHHH
M11111111110000
M11111111110000
111111111111011
Q11111111111011
11111111111101N
CCCF1111111101N
CCCF11111111011
CCCF111PP111111
