1MMM11JCCCCCCCC
111111IHHHHHHHH
DE1111000000000
CF1111000000000
CF1111111111111
CF1110001111111
CCDE1110111111Q
CCCF10001111111
CCCF10101111111
CCCF10001111111
