111111JCCCCCCCC
1111Q1IHHHHHHHH
DE1111000000000
CF1111000000000
CF1111111111111
O11111111110011
O11111111111011
O11111111110011
CCCF11111111011
CCCF11111110011
