1111111111
0111111110
0111111110
0111111110
0000200000
0111111110
0111711110
0111111110
0111E11110
1111111111
