1111110000
0111110000
0111111000
0111111000
0300200000
0111000000
0111000000
0000000000
0000000000
0000000000
