1111111111
1111115111
0201111000
1111111000
0114111000
1111011110
0117116110
0000000100
0000000100
0000000000
