1111127111
1111111110
1111111110
0111111410
0000200000
0111111110
0111111010
0111718110
0111111110
1111E11111
