1111127111
0111111110
0111111110
0111111410
0000200000
0111111110
0111711010
0111118110
0111E11110
1111111111
