1111111111
1111111111
1111111000
1111111000
0114111000
1111011110
0111010100
0000000100
0000000100
0000000000
