1111110000
0111110000
0111111000
0001111000
0000000000
0000000000
0000000000
0000000000
0000000000
0000000000
