1111111111
1111111111
0010000111
0010011111
0011000111
0000000011
0000000011
0000000011
0000000011
0000000011
