0000000000
0011110000
0000010000
0000010000
0000010000
0000010000
0000010000
0000010000
0000010000
0000000000
